"Year","Tows","All_Fish","Sexed_Fish","Unsexed_Fish","Sample_Size"
2003,70,307,262,45,166
2004,67,368,366,2,159
2005,69,261,245,16,164
2006,45,176,176,0,107
2007,39,85,76,9,85
2008,70,395,212,183,166
2010,79,225,168,57,188
2011,81,211,190,21,192
2012,90,185,173,12,185
2013,52,103,98,5,103
2014,97,257,244,13,230
2015,87,170,156,14,170
2016,70,162,150,12,162
